11111111111111111111
00000000000000000000
00000000000000000000
11117111111161111111
00000000800000001000
00000000100000001000
10000000900000009000
11117111111111111111
11111111111111111111
01171111111611111111
10000080000000010000
00000010000000010000
00000090000000090000
11171111111111111111
11111111111111111111