11111111111111111111
33333333333333333331
01000100010001000609
00000000000000000000
00000000000000000000
00000000000000000008
22212221222122212221
11111111111111111111
33313331333699999933
00000000000000400000
00000000000000400000
00000000000000400100
01000100010008888101
22222222222221111111
11111111111111111111