16117111117116117111
00000901000000900901
80208009000080208009
10101000008010101000
10101060801010101060
10101010101010101010
10101010101010101010
11111111111111111111
10101010101010101010
10101010101010101010
10101070901010101070
10101000009010101000
90309008000090309008
00800801000000800801
17116111116117116111