11111111111111111111
33313331333133313333
00000009060900090000
00000000000000001611
00000000000000000000
01000708000807080000
22222221222122211611
11111111111111111111
33313331333133313333
00000009060900090000
00000000000000001161
00000000000000000000
11000708000807080000
22222221222122211161
11111111111111111111