11111111111111111111
30103010101010101010
00000090101070901010
00000000901000009010
10001000009000800030
10201010000000100000
10101010608000106000
11111111111111111111
10101010709000107000
10301010000000100000
10006090008000900020
00000000801000008010
00000080101060801010
20102010101010101010
11111111111111111111