11111111111111111111
00000000000000000000
00000000000000001111
00000000000000013333
00000000000000130000
00000000000001300000
00000000000013000000
11111111111130000000
33333333333300000000
00000000000000000222
00000000000000002111
00000000000000021000
00000000000000210000
22222222222222100000
11111111111111111111