11111111111111111111
00000110000000022100
00000110000000011010
10000000001100011001
10001100001100000000
00001100000000110000
00000000110000110000
00000000110000000000
00011000000011000000
00011000000011000000
00000000110000000000
00011000110000000000
00011000000001100000
00033000000001100000
11111111111111111111