11111111111111111111
00040000040000040000
00040000040000040000
00000000040000040000
00000000040000040000
00000000040000000000
00000000040000000000
00040000000000000000
00040000000000000000
00040000000000040000
00040000000000040000
00040000040000040000
00040000040000040000
00040000040000040000
11111111111111111111