11111111111111111111
00000000000000000000
00000000000000000000
00000000000000000000
00000000000000000000
00000000000000000000
11111000000000000000
00000100000000000000
00000010000000000000
00000001000000000000
00000000100000000000
00000000011111111111
00000000000000000000
00000000000000000000
11111111111111111111