11111111111111111111
00000030000000009000
00000030000000009000
00600030000060009000
00700080000070002000
00000080000000002000
00000080000000002011
11111111111111111111
00000009000000000111
00000009000000000000
00070009000001000000
00060002000000010000
00000002000000000200
00000002222222222122
11111111111111111111