11111111111111111111
00000000000000010000
00000000000001000000
00000000000100000000
00000000010000000000
15111111000000000000
00000000000000000000
00000000000000000000
15111111000000000000
00000000010000000000
00000000000100000000
00000000000001000000
00000000000000010000
00000000000000000100
11111111111111111111