11111111111171161171
10101010000000000000
10101000002080208020
10100000201010101010
30900020101010101010
80088810101010101010
11611110101010101010
11711111111111111111
90099910101010101010
20800030101010101010
10100000301010101010
10101000003010101010
10101010000090309030
10101010100000008000
11111111111161171161