11111111111111111111
00000000000000000000
00000000000000000000
00000000000000000000
10000000000000000000
00100000000000000000
00001000000000000000
00000010000000000000
00000000100000000000
00000000001000000000
00000000000011111111
00000000000000000000
00000000000000000000
00000000000000000000
11111111111111111111