11111111111111111111
00000000000000000000
00000000000000000000
00000000000000000000
00000000000000000000
11117111161111711161
00600907008060000009
00000900008000090009
00000900008000090009
11111111111111711111
00000000000000000000
00000000000000000000
00000000000000000000
00000000000000000000
11111111111111111111