11111111111111111111
00000000000000000000
10011001100110000000
31133113311331100000
03300330033003300000
00000000000000011111
00000000000000000000
00000000000000000000
00000000000000000000
20022002200220011111
12211221122112200000
01100110011001100000
00000000000000000000
00000000000000000000
11111111111111111111