11111111111111111111
10101030101010101010
10709000101010101010
10000000101010101010
90008000903090309030
00201000000000008000
80101011111161171161
11111111161171161171
90101070009000009000
00301000008020802080
80009000801010101010
10000000101010101010
10608000101010101010
10101020101010101010
11111111111111111111