11111111111111111111
00000000000000000000
00000000000000000000
00000000000000000000
00000000000000000000
11111111111111111171
00008000090000800009
00008000090000800009
07008060090700806000
11161111711116111171
00000000000000000000
00000000000000000000
00000000000000000000
00000000000000000000
11111111111111111111