11111111111111111111
01000000000100000010
01000160000100000010
08000000000100000010
08000000000100000010
08000000000900000080
08000000000900000080
01000000000900000080
01000000000900000010
01000000000100700010
01000000000100000010
01000000000100000010
01000000000100000010
01000000000100000010
11111111111111111111