11111111111111111111
00000000000000000000
00000000000000000000
11111111111111111111
00000080000010000000
00000010000010000000
00000010000000000000
11711111111111111111
11111111111111111111
11111111111111111111
00000800000100000000
00000100000100000000
00000100000000000000
17111111111111111111
11111111111111111111