11111111111111111111
00010000111130000000
00030010000000000000
11101000000000000000
00000000000001000000
00000022200000010000
00212111100000000100
11131399900000000000
00000000000000000000
00000000000000000000
00010708000000000000
00002001000000000000
00001000010000000000
00000000000100000000
11111111111111111111