71161171111711611711
00000009010000090000
00002080090000208020
00801010000080101010
80101010608010101010
10101010101010101010
10101010101010101010
11111111111111111111
10101010101010101010
10101010101010101010
90101010709010101010
00901010000090101010
00003090080000309030
00000008010000080000
61171161111611711611