11111111111111111111
00000000000000000000
00000000000000000000
00000000000000000000
00000000000000000000
00000000000000000000
00000000000000000000
00000000000000000000
00000000000000000000
00000000000111111111
11111111111333000030
33330000000000000000
00000000000000000000
00000002220000222212
11111111111111111111