11111111111111111111
00000000000000000000
00000000000000000000
00000000000000000000
00000000000000000000
00000000000000000010
00000000011151111000
00000000000000000000
00000000000151111111
00000000000133331010
11111100000100001000
00000000000000000000
00000000000000000000
00022200000200002222
11111111111111111111