11111111111111111111
00000010000000003311
00001000040000000000
00100000040000000000
10000000040000010000
00000000040000000100
00000000040000000002
00000000042222222221
11111111111111111111
00003331013331013000
00000001000001000000
00000000000000000000
00001000001000001000
22221012221012221010
11111111111111111111