11111111111111111111
01010100000000000000
01010100000000000000
01010100000000000000
03030300000000000000
00000011111111111111
00000000000000000000
11111000000000000000
00000000000000000000
00000011111111111111
02020200000000000000
01010100000000000000
01010100000000000000
01010100000000000000
11111111111111111111