11111111111111111111
11000000000001110000
33000000000008880000
33000000000008880000
11000000000001110000
33000000000003330000
33000000000003330000
11000017000001110000
99000000000003330000
99000000000003330000
11000000000001110000
33000000000003330000
33000000000003330000
11000000000001110000
11111111111111111111