11117111111111111111
10100090101010101010
10000000301010709010
00002000003010000030
00201010000090008000
80101010100000201000
10101010106080101010
11111111111111111111
10101010107090101010
90101010100000301000
00301010000080009000
00003000002010000020
10000000201010608010
10100080101010101010
11116111111111111111