11111111111111111111
00011333333333000000
00099000000000000000
00000000000000000000
00000000000000000000
06888111100000000000
21111111111000000000
11111111111111111111
11100000090000000030
00000000090000000030
00000700090000700030
00000600020000600080
00000000020000000080
00000000020000000080
11111111111111111111