11111111111111111111
00000000000000000000
00000000000000000000
00000000000000000000
00000000000000000000
17116110000000000000
00800990000000000000
00800990000000000000
00800990000000000000
11111110000000000000
00000000000000000000
00000000000000000000
00000000000000000000
00000000000000000000
11111111111111111111