11111111111111111111
00000110000001100000
10011331100113311001
31133003311330033113
03300000033000000330
00000000000000000000
00000000000000000000
00000000000000000000
00000220000002200000
20022112200221122002
12211001122110011221
01100000011000000110
00000000000000000000
00000000000000000000
11111111111111111111