11111111111111111111
00000000000000000000
00000000000000000000
00000000000000000000
00000000000000000000
11111111171111111711
00000009000800090008
00000009000800090008
00000009000800090008
11111161111116111111
00000000000000000000
00000000000000000000
00000000000000000000
00000000000000000000
11111111111111111111