11111111111111111111
00000000000000000001
00000000000000000003
00000000000000000003
00000000000000000001
11111000000000000003
00000000000000000003
00000000000016000001
00000000000000000009
11111000000000000009
00000000000000000001
00000000000000000003
00000000000000000003
00000000000000000001
11111111111111111111