11111111111111111111
33333333333333100000
00000000000000310000
00000000000000031000
00000000000000003100
00000000000000000310
02222222222200000031
21111111111120000003
10000000000012000000
00000000000001200000
00000000000000120000
00000000000000012000
00000000000000001200
00000000000000000122
11111111111111111111