11111111111111111111
00000301010100101010
40000003010100101000
40000000030100100000
40000100000300000020
40000101000000002010
40000101010000201010
41111111111111111111
40000101010000301010
40000101000000003010
40000100000200000030
40000000020100100000
40000002010100101000
00000201010100101010
11111111111111111111