11111111111111111111
00000000000000000013
00000000000000000130
00000000000000001300
10000000000000013000
01000000000000130000
00100000000001300000
00010000000013000000
00001000000130000002
00000100001300000021
00000011113000000210
00000000000000002100
00000000000000021000
00000000000000210000
11111111111111111111