11111111111111111111
10101010101010101010
10101070101010101010
10101000901010101010
90309000009030903090
00800888800000800000
17116111116117116117
16117111117116117116
00900900100000900000
80208000900020802080
10101000008010101010
10101060801010101010
10101010101010101010
10101010101010101010
11111111111111111111