11111111111111111111
00000100000010000001
00000100000010000001
00000100000010000001
06000100700010006001
00000100000080000001
00000100000080000009
00000900000010000009
00000900000010000001
00000900000010000001
00000100000010000001
00000100000010000001
00000100000010000001
00000100000010000001
11111111111111111111