11111111111111111111
10010101000000030101
10010100000000000301
10010000020202000003
30000002010101010000
00000201010101010100
00020101010101010101
11111111111111111111
00030101010101010101
00000301010101010100
20000003010101010000
10010000030303000002
10010100000000000201
10010101000000020101
11111111111111111111