11111111111111111111
00000000000000000000
00000000000000000000
00000000000000000000
00000000000000000000
11111111111111111611
00090008000900080009
06090708060900080009
00090008000900080009
11111111111117111111
00000000000000000000
00000000000000000000
00000000000000000000
00000000000000000000
11111111111111111111