11111111111111111111
00000000000400000400
00000000000400000400
00000000000400000400
00000000000400000000
00000000000000000000
00000000000000000000
00000000000000000000
00000000000000000400
00000000000400000400
00000000000400000400
00000000000400000400
00000000000400000400
00000000000400000400
11111111111111111111