11111111111111111111
00000001110000000000
00000003330000000000
00000003330000000000
00000001110000000000
00000003330000000000
00000003330000000000
16000001110000170000
00000003330000000000
00000003330000000000
00000001110000000000
00000009990000000000
00000009990000000000
00000001110000000000
11111111111111111111