61171111111111111111
09000990101010101010
80208000301030101010
10101000009000301010
10101010000000003090
10101010608070000000
10101010101010600088
11111111111111111111
10101010101010700099
10101010709060000000
10101010000000002080
10101000008000201010
90309000201020101010
08000880101010101010
71161111111111111111