11111111111111111111
00301010103100101000
00003010000300100000
00000000000000000000
00100000001000002020
00101020001010201010
00101010001010101010
11111111111111111111
00101010001010101010
00101030001010301010
00100000001000003030
00000000000000000000
00002010000200100000
00201010102100101000
11111111111111111111