11111111111111111111
04000000000000220000
04000000000000110000
04000000000000110001
04000000001100000001
00000000001100000000
00000004000000001100
00000004000000001100
00000000000110000000
04000000000110000000
04000000000000000011
04000000000001100011
04000004000001100000
04000004000003300000
11111111111111111111