11111111111111111111
00000001000000000000
00000000010000000000
00000000000100000000
00000000000001000000
00000000000000011511
10000000000000000000
11111111111111100001
10000000000000000000
00000000000000011511
00000000000001000000
00000000000100000000
00000000010000000000
00000001000000000000
11111111111111111111