11111111111111111111
00000000100000000333
00000010000400000000
00001000000400000000
00100000000400000000
10000000000400000100
00000000000400000101
11111111111111111111
00000000000400000101
10000000000400000100
00100000000400000000
00001000000400000000
00000010000400000000
00000000100000000222
11111111111111111111