11111111111111111111
00000333333333333333
00000000000000000000
00000000000000000000
00000000000000000000
00000000000000000000
11111221112211122111
11111111111111111111
11113311133111331111
00000000000000000000
00000000000000000000
00000000000000000000
00000000000000000000
22222222222222222222
11111111111111111111