11111111111111111111
00000000000000000000
00000000000000000000
00000000000000000000
00000000000000000000
00000000000000000000
00000000000000000000
00000000000000000000
00000000000000000000
00000000000000000000
00011100000111000000
00000000000000000000
00000000000000000000
00000001110000011100
11111111111111111111