11111111115111111111
00000000010000000004
00000001000000000004
00000000000000000004
00000000000000000004
00000000000000000004
00000000000000000000
00000000000000001111
00000011110000100000
11000033330010000000
00000100006090000000
00000000000000000000
00000000000000000000
00000200002888800000
11111111111111111111