11111111111111111111
00000000000000000000
00000000000000000000
00000000000000000000
00000000000000000001
00000000000000000100
00000000000000010000
00000000001111000000
00000000100000000000
00000010000000000000
00001000000000000000
00100000000000000000
00000000000000000000
00000000000000000000
11111111111111111111