11111111111111111111
00000000000000000000
00000000000000000000
00000100000000000000
00000001000000000000
00000000010000000000
00000000000100000000
00000000000001000000
00000000000000010000
00000000000000000100
00000000000000000001
00000000000000000000
00000000000000000000
00000000000000000000
11111111111111111111